1111111111111111111111111111111111
1E0000000000000C00000C000000001
1010010100100000101001000000010111111
1010010010101010001001000000010111
1P0000000C00C00000000000000000C11
1111110011111111111111111111111111
111111111
